OBJECTID,Neighborhood,LAPD_Cost,LAPD_Days in Jail,LAPD_Arrests,LASD_Cost,LASD_Days in Jail,LASD_Arrests,2010 Population,Combo_Cost,Combo_Cost_PerPop,Combo_Days,Combo_Days_PerPop,Combo_Arrests,Combo_Arrests_PerPop,spa,sup_dist,Shape__Area,Shape__Length
1,Acton,25282,110,51,1103120,7367,396,6128,1128402,184.138707571802,7477,1.22013707571802,447,0.072943864229765,SPA 1 - Antelope Valley,District 5,1096711174.83203,179822.468865758
2,Agoura Hills,83892,365,216,587038,3288,470,17147,670930,39.1281273692191,3653,0.213040181956027,686,0.0400069983087421,SPA 2 - San Fernando,District 3,227118594.130859,82596.2026977214
3,Agua Dulce,10573,46,23,377880,2513,140,21499,388453,18.0684217870599,2559,0.119028792036839,163,0.00758174798827852,SPA 1 - Antelope Valley,District 5,877127647.651367,144935.193635646
4,Alhambra,301550,1312,647,2444920,16637,751,3535,2746470,776.936350777935,17949,5.07751060820368,1398,0.395473833097595,SPA 3 - San Gabriel,District 1,212539697.530273,69809.2042985743
5,Alondra Park,55621,242,112,667093,4244,326,83089,722714,8.69807074341971,4486,0.0539902995583049,438,0.00527145590872438,SPA 8 - South Bay,District 2,31778420.6816406,26478.2134642197
6,Altadena,221106,962,455,4779990,31710,1803,8557,5001096,584.445015776557,32672,3.81816057029333,2258,0.263877527170737,SPA 3 - San Gabriel,District 5,242830224.297852,97894.8685112307
7,Angeles Crest,0,0,0,21656,127,15,42356,21656,0.511285296061951,127,0.00299839456039286,15,0.00035414108981018,SPA 3 - San Gabriel,District 5,12001021023.5996,679104.079083431
8,Arcadia,63666,277,157,467051,2889,262,542,530717,979.182656826568,3166,5.84132841328413,419,0.773062730627306,SPA 3 - San Gabriel,District 5,310866309.369141,133366.897490173
9,Arleta,206856,900,429,465231,3207,126,56668,672087,11.8600797628291,4107,0.07247476529964,555,0.00979388720265405,SPA 2 - San Fernando,District 3,86316501.3984375,41121.3353124839
10,Artesia,28500,124,60,2758390,18178,1090,16522,2786890,168.677520881249,18302,1.10773514102409,1150,0.0696041641447767,SPA 7 - East,District 4,45503231.0205078,40922.0700272193
11,Atwater Village,286381,1246,607,128149,829,57,11982,414530,34.5960607578034,2075,0.173176431313637,664,0.0554164580203639,SPA 4 - Metro,District 1,49536949.8769531,41343.4101874983
12,Avalon,2528,11,5,521425,3229,291,3569,523953,146.806668534604,3240,0.907817315774727,296,0.0829363967497899,SPA 8 - South Bay,District 4,76517735.9394531,56490.7000243495
13,Avocado Heights,34706,151,70,4167110,28017,1419,12079,4201816,347.861246791953,28168,2.33198112426525,1489,0.123271794022684,SPA 3 - San Gabriel,District 1,82198299.5214844,87079.8298663036
14,Azusa,61137,266,131,3205300,21271,1206,43729,3266437,74.6972718333371,21537,0.492510690845892,1337,0.0305746758444053,SPA 3 - San Gabriel,District 1,275199769.430664,149560.08549691
15,Baldwin Park,129400,563,277,6320570,42906,1984,74506,6449970,86.5698064585403,43469,0.583429522454567,2261,0.0303465492711996,SPA 3 - San Gabriel,District 1,188960203.243164,87243.1634646635
16,Bel-Air,41831,182,113,14772,75,15,8261,56603,6.85183391841181,257,0.0311100351047089,128,0.0154944921922285,SPA 5 - West,District 3,177677964.960938,64300.6862484907
17,Bell,187090,814,403,2869740,19007,1095,35643,3056830,85.7624217939006,19821,0.556097971551216,1498,0.0420278876637769,SPA 7 - East,District 4,71202221.2861328,66160.9607324721
18,Bellflower,299711,1304,617,14077000,92202,5795,76616,14376711,187.646327137935,93506,1.22045003654589,6412,0.0836900908426438,SPA 7 - East,District 4,172715337.55957,59174.2414572487
19,Bell Gardens,178126,775,378,3072030,20235,1218,41571,3250156,78.1832527483101,21010,0.505400399316831,1596,0.0383921483726636,SPA 7 - East,District 4,69146375.2304688,39055.4892345622
20,Beverly Crest,88488,385,215,41272,202,45,10347,129760,12.5408330917174,587,0.0567314197351889,260,0.0251280564414806,SPA 5 - West,District 3,229609044.038086,93915.7009475445
21,Beverly Grove,212372,924,519,157162,914,112,20998,369534,17.5985331936375,1838,0.0875321459186589,631,0.0300504809981903,SPA 4 - Metro,District 3,45962637.5439453,45564.5595216353
22,Beverly Hills,190537,829,503,465616,3166,144,34109,656153,19.2369462605178,3995,0.117124512591985,647,0.0189686006625817,SPA 5 - West,District 3,158969329.804688,87518.2779344612
23,Beverlywood,37924,165,80,26628,167,14,5391,64552,11.9740307920608,332,0.0615841216842886,94,0.0174364681877203,SPA 5 - West,District 3,22144974.4951172,20475.4469552579
24,Boyle Heights,4107241,17870,7527,6579180,43274,2634,90048,10686421,118.674717928216,61144,0.679015636105188,10161,0.112839818763326,SPA 4 - Metro,District 1,181739397.615234,58425.9529992494
25,Bradbury,4597,20,8,30022,178,20,1292,34619,26.7948916408669,198,0.153250773993808,28,0.021671826625387,SPA 3 - San Gabriel,District 5,53761312.1835938,35942.2370815604
26,Brentwood,186170,810,483,55896,271,62,32540,242066,7.43902888752305,1081,0.033220651505839,545,0.0167486170866626,SPA 5 - West,District 3,424412346.705078,121045.935656443
27,Burbank,926945,4033,2081,986142,6598,349,103340,1913087,18.512550803174,10631,0.102874008128508,2430,0.0235146119605187,SPA 2 - San Fernando,District 5,483462717.240234,102001.004706376
28,Calabasas,133307,580,352,627260,3726,415,24159,760567,31.4817252369717,4306,0.178235854133035,767,0.031748002814686,SPA 2 - San Fernando,District 3,516938283.949219,139076.797404174
29,Canoga Park,3452886,15023,7030,595681,3546,391,58943,4048567,68.6861374548292,18569,0.31503316763653,7421,0.12590129447093,SPA 2 - San Fernando,District 3,121229700.776367,51030.2509634741
30,Carson,689290,2999,1358,19126800,125879,7627,91800,19816090,215.861546840959,128878,1.40389978213508,8985,0.0978758169934641,SPA 8 - South Bay,District 2,533859770.834961,130812.683261859
31,Carthay,69182,301,150,186617,1217,79,5068,255799,50.473362273086,1518,0.299526440410418,229,0.0451854775059195,SPA 4 - Metro,District 2,14069549.265625,15325.2248293831
32,Castaic,72170,314,155,1550800,9734,812,13194,1622970,123.008185538881,10048,0.761558284068516,967,0.0732908897983932,SPA 2 - San Fernando,District 5,152678121.024414,93972.3382008006
33,Castaic Canyons,66654,290,147,1718850,11062,788,42023,1785504,42.48873236085,11352,0.270137781690979,935,0.0222497203912143,SPA 2 - San Fernando,District 5,5372240023.25781,623313.665927427
34,Century City,45738,199,115,24536,139,19,5713,70274,12.3007176614738,338,0.0591633117451427,134,0.0234552774374234,SPA 5 - West,District 3,19531919.5712891,18238.9548288633
35,Cerritos,53093,231,127,2022180,12663,1071,49041,2075273,42.3171020166799,12894,0.262922860463694,1198,0.0244285393854122,SPA 7 - East,District 4,246953932.966797,119797.464438082
36,Charter Oak,16089,70,34,1281480,8729,390,10070,1297569,128.854915590864,8799,0.873783515392254,424,0.0421052631578947,SPA 3 - San Gabriel,District 5,25691090.1708984,56860.1764894198
37,Chatsworth,1099095,4782,2342,601190,3773,315,44264,1700285,38.4123667088379,8555,0.19327218507139,2657,0.0600262063979758,SPA 2 - San Fernando,District 3,424966992.493164,140638.146563142
38,Chatsworth Reservoir,2758,12,8,1763,6,3,8,4521,565.125,18,2.25,11,1.375,SPA 2 - San Fernando,District 3,50211579.3896484,37138.8643743102
39,Cheviot Hills,44359,193,97,20671,122,14,9023,65030,7.20713731574864,315,0.034910783553142,111,0.0123018951568215,SPA 5 - West,District 3,42833294.4013672,26750.272681403
40,Chinatown,294885,1283,565,174125,1108,85,16437,469010,28.5337957048123,2391,0.145464500821318,650,0.0395449291233193,SPA 4 - Metro,District 1,25351693.4619141,23500.4747510485
41,Citrus,18847,82,38,2143790,14372,747,17532,2162637,123.353696098563,14454,0.824435318275154,785,0.0447752680812229,SPA 3 - San Gabriel,District 1,28200413.3056641,56465.1918684647
42,Claremont,19766,86,46,193601,1099,149,37361,213367,5.71095527421643,1185,0.0317175664462943,195,0.0052193463772383,SPA 3 - San Gabriel,District 5,464501058.518555,134386.923626601
43,Commerce,102279,445,207,2596810,17399,909,13158,2699089,205.129122967016,17844,1.35613315093479,1116,0.0848153214774282,SPA 7 - East,District 4,183455634.94043,93160.8913448744
44,Compton,1338818,5825,2575,34228400,231297,11177,101456,35567218,350.567911212742,237122,2.3371905062293,13752,0.135546443778584,SPA 6 - South,District 2,286043791.12793,170489.497295437
45,Covina,92396,402,197,3138360,20780,1200,53063,3230756,60.8852873000019,21182,0.399185873395775,1397,0.0263271959745962,SPA 3 - San Gabriel,District 1,211988045.115234,132757.046691169
46,Cudahy,109634,477,224,4031130,27424,1241,23805,4140764,173.945137576139,27901,1.17206469229154,1465,0.0615416929216551,SPA 7 - East,District 4,34263538.1679688,34729.08180152
47,Culver City,388430,1690,849,339417,2120,182,36672,727847,19.8474858202443,3810,0.103893979057592,1031,0.028114092495637,SPA 5 - West,District 2,144765839.306641,116903.099852947
48,Cypress Park,433938,1888,822,246938,1619,101,8876,680876,76.7097791798107,3507,0.395110410094637,923,0.103988283010365,SPA 4 - Metro,District 1,20196836.3408203,28566.0254429908
49,Del Aire,51024,222,110,658662,4173,329,10261,709686,69.1634343631225,4395,0.428320826430172,439,0.0427833544488841,SPA 8 - South Bay,District 2,27594846.8349609,34295.8462719299
50,Del Rey,689750,3001,1498,292751,1787,174,29466,982501,33.3435484965723,4788,0.162492364080635,1672,0.0567433652345076,SPA 5 - West,District 2,68375896.6660156,50159.4652581585
51,Desert View Highlands,11952,52,26,1021960,6993,298,3259,1033912,317.248235655109,7045,2.16170604479902,324,0.0994169990794722,SPA 1 - Antelope Valley,District 5,12354975.6660156,24372.4764351724
52,Diamond Bar,37694,164,95,2406780,15339,1165,46826,2444474,52.2033485670354,15503,0.331076752231666,1260,0.0269081279630974,SPA 3 - San Gabriel,District 1,421689484.256836,113425.332303805
53,Downey,350966,1527,784,7031180,45959,2933,111772,7382146,66.0464695988262,47486,0.424847009984612,3717,0.0332551980818094,SPA 7 - East,District 4,349301720.579102,89806.9052489035
54,Downtown,7321323,31854,12203,4219200,28669,1313,43052,11540523,268.060090123572,60523,1.40581157669795,13516,0.313945925857103,SPA 4 - Metro,District 1,162758797.339844,56448.8224025567
55,Duarte,43440,189,88,3176760,21597,984,21321,3220200,151.034191642043,21786,1.02180948360771,1072,0.0502790675859481,SPA 3 - San Gabriel,District 5,186476004.77832,112422.6232379
56,Eagle Rock,627463,2730,1219,534961,3663,155,32166,1162424,36.138282658708,6393,0.198750233165454,1374,0.042715911210595,SPA 4 - Metro,District 1,118504248.933594,59993.3856179666
57,East Compton,113081,492,220,4923770,33562,1489,11897,5036851,423.371522232496,34054,2.86240228629066,1709,0.143649659578045,SPA 6 - South,District 2,23260594.7744141,50535.2423604583
58,East Hollywood,3454495,15030,6852,1487910,9981,516,69639,4942405,70.9717974123695,25011,0.359152199198725,7368,0.105802782923362,SPA 4 - Metro,District 1,66315351.5908203,32233.9238774234
59,East La Mirada,8044,35,18,1032670,6586,498,9757,1040714,106.663318643026,6621,0.678589730449933,516,0.0528851081274982,SPA 7 - East,District 4,30946835.0517578,26446.1839831111
60,East Los Angeles,1233321,5366,2417,32635100,216085,12479,125606,33868421,269.640152540484,221451,1.76306068181456,14896,0.118593060841043,SPA 7 - East,District 1,208139094.803711,87694.6396880484
61,East Pasadena,20915,91,46,440620,2904,174,4841,461535,95.3387729807891,2995,0.618673827721545,220,0.0454451559595125,SPA 3 - San Gabriel,District 5,36462907.3378906,40521.800466851
62,East San Gabriel,36545,159,86,1165820,7626,484,24085,1202365,49.9217355200332,7785,0.323230226281918,570,0.0236661822711231,SPA 3 - San Gabriel,District 5,60851349.7773438,87992.3668818525
63,Echo Park,1222979,5321,2425,592643,3867,250,37475,1815622,48.4488859239493,9188,0.245176784523015,2675,0.0713809206137425,SPA 4 - Metro,District 1,66860227.7832031,42898.6060044161
64,Elizabeth Lake,1839,8,4,138433,914,54,749,140272,187.279038718291,922,1.23097463284379,58,0.0774365821094793,SPA 1 - Antelope Valley,District 5,175789099.186523,77928.796210106
65,El Monte,269602,1173,564,11952100,80463,4027,114708,12221702,106.546204275203,81636,0.711685322732503,4591,0.0400233636712348,SPA 3 - San Gabriel,District 1,270190368.017578,108521.591299192
66,El Segundo,60678,264,147,164067,1093,60,16654,224745,13.4949561666867,1357,0.0814819262639606,207,0.0124294463792482,SPA 8 - South Bay,District 2,152188378.961914,57829.4371759023
67,El Sereno,1449141,6305,2686,2021750,13394,770,39582,3470891,87.6886210903946,19699,0.49767571118185,3456,0.08731241473397,SPA 4 - Metro,District 1,116190981.152344,50955.0274279449
68,Elysian Park,36774,160,76,65161,441,21,1894,101935,53.8199577613516,601,0.317317845828933,97,0.0512143611404435,SPA 4 - Metro,District 1,45862309.1347656,29450.0993373856
69,Elysian Valley,183872,800,367,82787,540,35,6889,266659,38.707940194513,1340,0.19451299172594,402,0.058353897517782,SPA 4 - Metro,District 1,22017225.1835938,27768.6797862217
70,Encino,755714,3288,1786,254877,1557,151,43648,1010591,23.1532028958944,4845,0.111001649560117,1937,0.0443777492668622,SPA 2 - San Fernando,District 3,264836574.517578,89700.6289949202
71,Fairfax,182033,792,412,151608,894,103,12480,333641,26.7340544871795,1686,0.135096153846154,515,0.0412660256410256,SPA 4 - Metro,District 3,34400955.7490234,24342.3605429751
72,Gardena,529551,2304,1113,3271810,21227,1430,58829,3801361,64.6171276071325,23531,0.399989800948512,2543,0.0432269798908701,SPA 8 - South Bay,District 2,162918318.885742,65902.7482893536
73,Glassell Park,640334,2786,1251,501015,3470,129,24064,1141349,47.4297290558511,6256,0.259973404255319,1380,0.0573470744680851,SPA 4 - Metro,District 1,76746711.3720703,50081.6038102651
74,Glendale,1196547,5206,2887,1297220,8099,697,190790,2493767,13.0707427013994,13305,0.0697363593479742,3584,0.0187850516274438,SPA 2 - San Fernando,District 5,853858979.600586,191575.583313458
75,Glendora,37004,161,87,2039700,13676,710,53856,2076704,38.5603089720737,13837,0.256925876411171,797,0.0147987225193108,SPA 3 - San Gabriel,District 5,544781179.915039,148052.524105392
76,Granada Hills,1296068,5639,2787,1006290,6777,338,53692,2302358,42.8808388586754,12416,0.231244878194144,3125,0.0582023392684199,SPA 2 - San Fernando,District 3,421282456.370117,89932.580963734
77,Green Valley,919,4,2,84446,594,18,0,85365,,598,,20,,SPA 2 - San Fernando,District 5,72628728.1123047,48288.3761443436
78,Griffith Park,4827,21,11,30431,225,2,14,35258,2518.42857142857,246,17.5714285714286,13,0.928571428571429,SPA 4 - Metro,District 5,162629217.97168,70756.9733491005
79,Hacienda Heights,62516,272,161,6614670,43264,2748,53568,6677186,124.648782855436,43536,0.812724014336918,2909,0.0543048088410992,SPA 3 - San Gabriel,District 1,331391973.875,91726.0189109301
80,Hancock Park,149396,650,346,297184,2001,100,9809,446580,45.5275767152615,2651,0.270262004281782,446,0.0454684473442757,SPA 4 - Metro,District 2,42318831.4501953,26484.412129517
81,Hansen Dam,34706,151,73,3600,15,5,33,38306,1160.78787878788,166,5.03030303030303,78,2.36363636363636,SPA 2 - San Fernando,District 5,54671460.8115234,35865.9774654231
82,Harbor City,516910,2249,1062,1832910,12070,728,23727,2349820,99.0356977283264,14319,0.603489695283854,1790,0.0754414801702702,SPA 8 - South Bay,District 4,71963081.5722656,45295.263156607
83,Harbor Gateway,1141615,4967,2227,3750530,24614,1524,40137,4892145,121.886164885268,29581,0.737000772354685,3751,0.0934549169095847,SPA 8 - South Bay,District 2,143320679.300781,105279.174475016
84,Hasley Canyon,5746,25,8,38095,178,45,0,43841,,203,,53,,SPA 2 - San Fernando,District 5,86478346.7841797,67732.2742866476
85,Hawaiian Gardens,15169,66,37,3478110,22922,1374,12968,3493279,269.376850709439,22988,1.77267119062307,1411,0.108806292412091,SPA 7 - East,District 4,27462239.7070313,26742.9567770423
86,Hawthorne,885803,3854,1821,5782550,37505,2532,86046,6668353,77.4975362015666,41359,0.480661506635985,4353,0.0505892197196848,SPA 8 - South Bay,District 2,173672196.985352,103310.719930839
87,Hermosa Beach,27811,121,77,154491,967,82,19506,182302,9.3459448374859,1088,0.0557777094227417,159,0.00815133804983082,SPA 8 - South Bay,District 2,41193863.25,28570.667048842
88,Hidden Hills,5976,26,16,30742,181,21,1985,36718,18.4977329974811,207,0.104282115869018,37,0.018639798488665,SPA 2 - San Fernando,District 3,47504035.2509766,43877.8768598127
89,Highland Park,2087407,9082,3994,640871,3902,385,53332,2728278,51.1564914122853,12984,0.24345608640216,4379,0.0821083027075677,SPA 4 - Metro,District 1,95327878.4550781,64005.2082017081
90,Hollywood,4309960,18752,8402,2796770,18485,1083,71133,7106730,99.9076378052381,37237,0.523484177526605,9485,0.133341768236965,SPA 4 - Metro,District 3,97690846.4052734,47755.1240311112
91,Hollywood Hills,479676,2087,1103,380299,2502,152,23245,859975,36.9961281996128,4589,0.19741879974188,1255,0.0539901053990105,SPA 4 - Metro,District 5,196476903.992188,71502.399155134
92,Hollywood Hills West,214900,935,510,225994,1412,121,16324,440894,27.0089438863024,2347,0.143776035285469,631,0.0386547414849302,SPA 4 - Metro,District 3,135895303.68457,62687.416471767
93,Huntington Park,323615,1408,693,3950310,25867,1629,59737,4273925,71.5456919497129,27275,0.456584696251904,2322,0.0388703818404004,SPA 7 - East,District 4,84601628.3154297,66649.7232211981
94,Industry,1839,8,4,757721,5114,250,18943,759560,40.0971335057805,5122,0.270390117721586,254,0.0134086469936124,SPA 3 - San Gabriel,District 1,344308113.660156,370635.136392476
95,Inglewood,2061895,8971,4156,7995390,52445,3260,110579,10057285,90.9511299613851,61416,0.555403828936778,7416,0.0670651751236672,SPA 8 - South Bay,District 2,254325749.942383,94409.5224301435
96,Irwindale,6436,28,12,142105,871,83,1422,148541,104.459212376934,899,0.632208157524613,95,0.0668073136427567,SPA 3 - San Gabriel,District 1,267138009.193359,134064.78255967
97,Koreatown,3941526,17149,8103,1478330,9450,704,104833,5419856,51.6999036562914,26599,0.253727356843742,8807,0.0840098060725153,SPA 4 - Metro,District 2,75285132.2666016,37596.8522674422
98,La Crescenta-Montrose,58150,253,139,590808,3758,289,21442,648958,30.2657401361813,4011,0.187062773994963,428,0.0199608245499487,SPA 2 - San Fernando,District 5,95523760.5400391,55550.7113804582
99,Ladera Heights,115839,504,230,335185,2210,132,8294,451024,54.3795514829998,2714,0.327224499638293,362,0.0436460091632505,SPA 5 - West,District 2,81955164.0371094,61985.3805961326
100,La Habra Heights,8044,35,14,301625,1976,124,5591,309669,55.3870506170631,2011,0.359685208370596,138,0.0246825254873904,SPA 7 - East,District 4,173606170.041992,65050.5333759124
101,Lake Balboa,923267,4017,1962,473053,3149,174,26160,1396320,53.3761467889908,7166,0.273929663608563,2136,0.081651376146789,SPA 2 - San Fernando,District 3,87143798.4140625,42156.1831277563
102,Lake Hughes,919,4,2,23503,119,24,0,24422,,123,,26,,SPA 2 - San Fernando,District 5,261611699.911133,121497.461678254
103,Lake Los Angeles,47117,205,89,5757290,39817,1506,1947,5804407,2981.20544427324,40022,20.5557267591166,1595,0.819209039548023,SPA 1 - Antelope Valley,District 5,193983386.067383,93690.3222844452
104,Lake View Terrace,472781,2057,965,447734,3048,137,13054,920515,70.5159338133905,5105,0.391067871916654,1102,0.0844185690209897,SPA 2 - San Fernando,District 5,117954784.740234,87174.3022685833
105,Lakewood,141352,615,292,8120360,52806,3499,80585,8261712,102.521709995657,53421,0.662914934541168,3791,0.0470434944468574,SPA 7 - East,District 4,265192859.175781,124633.935092894
106,La Mirada,42061,183,96,4613520,29445,2216,48527,4655581,95.9379520679209,29628,0.610546705957508,2312,0.0476435798627568,SPA 7 - East,District 4,218601451.655273,80557.2619097235
107,Lancaster,840295,3656,1551,80471600,559316,19910,151745,81311895,535.845629180533,562972,3.70998714949422,21461,0.141428053642624,SPA 1 - Antelope Valley,District 5,2854738435.70117,492400.968051435
108,La Puente,54472,237,120,12822800,86279,4339,40174,12877272,320.537462040125,86516,2.15353213521183,4459,0.110992183999602,SPA 3 - San Gabriel,District 1,97207776.9277344,87072.9734573458
109,Larchmont,181114,788,396,117609,825,26,7822,298723,38.1901048325237,1613,0.206213244694452,422,0.0539503963180772,SPA 4 - Metro,District 3,13558159.9990234,15520.3272631501
110,La Verne,25972,113,66,789454,5161,329,33069,815426,24.6583204814176,5274,0.159484713780278,395,0.011944721642626,SPA 3 - San Gabriel,District 5,239000081.535156,107091.742001845
111,Lawndale,157440,685,341,3914680,24827,1945,32769,4072120,124.267447892826,25512,0.778540693948549,2286,0.0697610546553145,SPA 8 - South Bay,District 2,54877648.8789063,37149.0120411938
112,Lennox,179965,783,388,4100030,26476,1843,22532,4279995,189.951846263092,27259,1.20979052014912,2231,0.0990147345996805,SPA 8 - South Bay,District 2,29679775.3886719,32731.2506164348
113,Leona Valley,3907,17,7,302472,2119,68,3553,306379,86.2310723332395,2136,0.601182099634112,75,0.0211089220377146,SPA 1 - Antelope Valley,District 5,427330023.948242,167363.722668945
114,Lincoln Heights,1004171,4369,1904,934203,6252,330,26605,1938374,72.8575079872204,10621,0.39921067468521,2234,0.0839691787258034,SPA 4 - Metro,District 1,69990211.4960938,50780.0411186942
115,Littlerock,6895,30,14,582000,4072,133,0,588895,,4102,,147,,SPA 1 - Antelope Valley,District 5,50539989.6835938,38210.0158472337
116,Lomita,113541,494,240,2446420,15797,1100,20795,2559961,123.104640538591,16291,0.783409473431113,1340,0.0644385669632123,SPA 8 - South Bay,District 4,53447955.9570313,44721.2706973275
117,Long Beach,2085798,9075,4101,23938400,158306,9234,465275,26024198,55.932938584708,167381,0.359746386545591,13335,0.028660469614744,SPA 8 - South Bay,District 4,1452474561.02441,470493.835217218
118,Lopez/Kagel Canyons,23903,104,43,129269,896,33,533,153172,287.377110694184,1000,1.87617260787993,76,0.142589118198874,SPA 3 - San Gabriel,District 5,99649072.9267578,77786.925546349
119,Los Feliz,607237,2642,1333,272892,1737,133,32639,880129,26.965562670425,4379,0.134164649652257,1466,0.0449155917767088,SPA 4 - Metro,District 5,72705599.8857422,36266.5465305419
120,Lynwood,445660,1939,879,16614800,111077,5916,68736,17060460,248.202688547486,113016,1.64420391061453,6795,0.0988564944134078,SPA 6 - South,District 4,136610457.011719,72720.9502999591
121,Malibu,32637,142,85,673278,3998,446,8179,705915,86.3082283897787,4140,0.506174348942414,531,0.0649223621469617,SPA 5 - West,District 3,554398969.360352,251713.11753857
122,Manhattan Beach,41831,182,100,110499,642,79,35135,152330,4.3355628290878,824,0.0234523978938381,179,0.00509463497936531,SPA 8 - South Bay,District 2,110697138.682617,48153.9577743419
123,Marina del Rey,59758,260,166,238702,1508,121,8866,298460,33.6634333408527,1768,0.19941348973607,287,0.0323708549515001,SPA 5 - West,District 2,40556699.2304688,26015.4349826091
124,Mar Vista,543572,2365,1201,314985,2094,117,34925,858557,24.5828775948461,4459,0.127673586256263,1318,0.0377380100214746,SPA 5 - West,District 3,80715027.4462891,40858.239520663
125,Mayflower Village,18847,82,44,2427170,16481,760,12014,2446017,203.597219910105,16563,1.37864158481771,804,0.0669219244215082,SPA 3 - San Gabriel,District 5,33882822.2998047,49389.7162705578
126,Maywood,102968,448,222,3945110,26157,1494,27395,4048078,147.767037780617,26605,0.971162620916226,1716,0.0626391677313378,SPA 7 - East,District 4,33121433.0371094,30178.7569780592
127,Mid-Wilshire,1076800,4685,2248,619404,3874,330,44783,1696204,37.8760690440569,8559,0.19112163097604,2578,0.0575664872831208,SPA 4 - Metro,District 2,77534525.2275391,41002.0697277295
128,Mission Hills,776170,3377,1558,553536,3796,158,19630,1329706,67.7384615384615,7173,0.36541008660214,1716,0.0874172185430464,SPA 2 - San Fernando,District 3,88862313.546875,44053.3799697861
129,Monrovia,83202,362,180,1357850,8618,672,37254,1441052,38.6818059805658,8980,0.241047941160681,852,0.0228700273796102,SPA 3 - San Gabriel,District 5,388344967.227539,157769.153329719
130,Montebello,295115,1284,614,5331730,34524,2358,62381,5626845,90.2012632051426,35808,0.574020935861881,2972,0.0476427117231208,SPA 7 - East,District 1,235692305.432617,102883.465620912
131,La Canada Flintridge,26202,114,70,45248,193,61,19380,71450,3.68679050567595,307,0.0158410732714138,131,0.00675954592363261,SPA 2 - San Fernando,District 5,239882521.699219,92448.8704497413
132,Montecito Heights,500362,2177,961,408496,2715,152,20028,908858,45.379368883563,4892,0.244258038745756,1113,0.0555721989215099,SPA 4 - Metro,District 1,67177011.0458984,51532.9850139327
133,Monterey Park,163186,710,385,1313510,8205,704,60678,1476696,24.336596460002,8915,0.146923102277597,1089,0.0179471966775438,SPA 3 - San Gabriel,District 1,213573181.44043,81562.2850875822
134,Mount Washington,277647,1208,551,88429,507,66,15198,366076,24.087116725885,1715,0.112843795236215,617,0.0405974470325043,SPA 4 - Metro,District 1,51586289.3144531,33112.5101072622
135,Northeast Antelope Valley,59758,260,108,3762080,26338,853,20762,3821838,184.07850881418,26598,1.28109045371352,961,0.0462864849243811,SPA 1 - Antelope Valley,District 5,12321571006.4395,719736.46362701
136,North El Monte,12871,56,22,348157,2408,91,3151,361028,114.575690257061,2464,0.781973976515392,113,0.0358616312281815,SPA 3 - San Gabriel,District 5,11897671.6601563,16516.3751996349
137,North Hills,2773249,12066,5592,719713,4561,359,56375,3492962,61.9594146341463,16627,0.294935698447894,5951,0.105560975609756,SPA 2 - San Fernando,District 3,147981805.09082,58066.6620184261
138,North Hollywood,4033232,17548,8400,912852,5898,409,76581,4946084,64.5863073086013,23446,0.306159491257623,8809,0.115028531881276,SPA 2 - San Fernando,District 5,163621511.976563,58941.4194101467
139,Northridge,1667489,7255,3636,595558,3789,291,61310,2263047,36.9115478714728,11044,0.180133746534008,3927,0.0640515413472517,SPA 2 - San Fernando,District 3,263938344.923828,67856.7792751796
140,Northwest Antelope Valley,9653,42,18,1117880,7720,297,7037,1127533,160.229216995879,7762,1.10302685803609,315,0.0447633934915447,SPA 1 - Antelope Valley,District 5,5962030414.2373,612558.942037764
141,Northwest Palmdale,4597,20,14,715549,4893,210,5223,720146,137.879762588551,4913,0.940647137660348,224,0.0428872295615547,SPA 1 - Antelope Valley,District 5,161285691.573242,66981.7524538928
142,North Whittier,8734,38,17,393155,2443,216,5147,401889,78.0821837963862,2481,0.482028366038469,233,0.0452690887895862,SPA 7 - East,District 4,152214348.90918,81028.0507388287
143,Norwalk,261558,1138,547,23399900,154880,8971,106317,23661458,222.555734266392,156018,1.46747933068089,9518,0.0895247232333493,SPA 7 - East,District 4,272197928.766602,93617.2781625002
144,Pacific Palisades,119287,519,311,128522,744,93,24476,247809,10.1245710083347,1263,0.0516015688838045,404,0.0165059650269652,SPA 5 - West,District 3,636675648.801758,133554.82791685
145,Pacoima,4597719,20004,8977,1549910,10142,642,77868,6147629,78.9493630246057,30146,0.387142343453023,9619,0.123529562849951,SPA 2 - San Fernando,District 3,198983540.550781,66639.8604672998
146,Palmdale,907178,3947,1781,56576900,387392,16394,152443,57484078,377.085717284493,391339,2.56711688959152,18175,0.119224890614853,SPA 1 - Antelope Valley,District 5,3747349074.51758,531375.247260874
147,Palms,640334,2786,1462,300676,1942,135,42733,941010,22.0206865888189,4728,0.110640488615356,1597,0.0373715863618281,SPA 5 - West,District 3,54233484.3164063,38337.4602292351
148,Palos Verdes Estates,230,1,1,25341,128,26,13438,25571,1.90288733442477,129,0.00959964280398869,27,0.00200922756362554,SPA 8 - South Bay,District 4,131786857.848633,70244.8185977977
149,Panorama City,3648710,15875,7333,611379,3889,299,67889,4260089,62.7507990985285,19764,0.291122273122303,7632,0.112418801278558,SPA 2 - San Fernando,District 3,101700260.746094,48457.5155930758
150,Paramount,206626,899,435,9939700,65398,3971,54098,10146326,187.55454915154,66297,1.2254981699878,4406,0.0814447853894784,SPA 6 - South,District 4,135339207.817383,68718.7407737748
151,Pasadena,716411,3117,1494,5766970,38285,2164,140137,6483381,46.2645910787301,41402,0.295439462811392,3658,0.0261030277514147,SPA 3 - San Gabriel,District 5,701031867.72168,263988.744090384
152,Pico Rivera,192606,838,414,18549200,123558,6790,64234,18741806,291.773920353707,124396,1.9366067814553,7204,0.112152442631628,SPA 7 - East,District 4,244964182.939453,98215.326701705
153,Pico-Robertson,235126,1023,532,162033,1063,66,17446,397159,22.7650464289809,2086,0.119568955634529,598,0.0342771982116244,SPA 5 - West,District 3,28758137.9023438,32128.6789981344
154,Pico-Union,2270819,9880,4382,1391050,9381,462,44150,3661869,82.9415402038505,19261,0.436262740656852,4844,0.109716874292186,SPA 4 - Metro,District 1,46542110.6279297,29048.5573503892
155,Playa del Rey,129170,562,302,123384,793,57,11233,252554,22.4832190866198,1355,0.12062672482863,359,0.0319594053236001,SPA 5 - West,District 2,76785267.015625,69436.5142908223
156,Playa Vista,68262,297,172,28692,146,29,8592,96954,11.284217877095,443,0.0515595903165736,201,0.0233938547486034,SPA 5 - West,District 2,36222168.3271484,30806.7501492169
157,Pomona,330740,1439,636,7834560,52140,2887,148840,8165300,54.8595807578608,53579,0.359977156678312,3523,0.0236697124428917,SPA 3 - San Gabriel,District 1,638983542.422852,158757.764687101
158,Porter Ranch,317869,1383,773,199362,1284,91,26514,517231,19.5078449121219,2667,0.100588368409142,864,0.0325865580448065,SPA 2 - San Fernando,District 3,155733438.329102,54425.3685298486
159,Quartz Hill,15859,69,34,3125870,21959,678,9812,3141729,320.192519364044,22028,2.24500611496127,712,0.0725642070933551,SPA 1 - Antelope Valley,District 5,105346158.599609,71017.0064097573
160,Ramona,2069,9,5,129235,825,62,3931,131304,33.4021877384889,834,0.212159755787331,67,0.0170440091579751,SPA 3 - San Gabriel,District 1,100712789.382813,97375.9095260515
161,Rancho Dominguez,11492,50,26,348674,2368,109,2666,360166,135.096024006001,2418,0.906976744186046,135,0.0506376594148537,SPA 8 - South Bay,District 2,74335716.8701172,40332.3477194921
162,Rancho Palos Verdes,69871,304,159,728430,4500,411,41967,798301,19.0221126122906,4804,0.114470893797508,570,0.0135821002216027,SPA 8 - South Bay,District 4,373404541.370117,202850.908390424
163,Rancho Park,55621,242,109,32914,234,6,4152,88535,21.3234585741811,476,0.114643545279383,115,0.0276974951830443,SPA 5 - West,District 3,16702533.3359375,20136.9180149801
164,Redondo Beach,127331,554,308,987030,6412,428,66748,1114361,16.695047042608,6966,0.104362677533409,736,0.0110265476119135,SPA 8 - South Bay,District 2,174116148.333008,112892.480121764
165,Reseda,3332910,14501,6776,1082720,7108,439,68921,4415630,64.0679908881183,21609,0.313532885477576,7215,0.104685074215406,SPA 2 - San Fernando,District 3,163520465.524414,51257.6754441651
166,Ridge Route,2069,9,3,77127,507,31,5769,79196,13.7278557808979,516,0.0894435777431097,34,0.00589356907609638,SPA 2 - San Fernando,District 5,8159258974.18555,456848.184344877
167,Rolling Hills,1839,8,4,46537,293,24,3295,48376,14.6816388467375,301,0.091350531107739,28,0.00849772382397572,SPA 8 - South Bay,District 4,100421495.566406,52819.7833033578
168,Rolling Hills Estates,12182,53,31,254177,1681,98,6914,266359,38.524587792884,1734,0.250795487416835,129,0.018657795776685,SPA 8 - South Bay,District 4,106337895.984375,109143.023183783
169,Rosemead,117908,513,249,7067030,47652,2350,51859,7184938,138.547561657571,48165,0.92876839121464,2599,0.0501166624886712,SPA 3 - San Gabriel,District 1,143758854.552734,96559.7000374416
170,Rowland Heights,51024,222,107,4463910,28893,1979,45871,4514934,98.4267620064965,29115,0.634714743519871,2086,0.0454753547993286,SPA 3 - San Gabriel,District 1,367586348.701172,107455.095268778
171,San Dimas,35166,153,79,2509440,16156,1148,34105,2544606,74.610936812784,16309,0.478199677466647,1227,0.0359771294531594,SPA 3 - San Gabriel,District 5,435689219.825195,170430.974705999
172,San Fernando,680326,2960,1394,549925,3637,212,23645,1230251,52.030069782195,6597,0.279001903150772,1606,0.0679213364347642,SPA 2 - San Fernando,District 3,66566932.3427734,37170.1084562301
173,San Gabriel,88029,383,213,1100470,7086,503,38873,1188499,30.5738944768863,7469,0.192138502302369,716,0.0184189540297893,SPA 3 - San Gabriel,District 1,116166389.056641,95885.2857297996
174,San Marino,11952,52,29,12855,41,23,13147,24807,1.88689434852058,93,0.00707385715372328,52,0.00395527496767323,SPA 3 - San Gabriel,District 5,105496562.385742,57020.3711484895
175,San Pasqual,4137,18,10,18066,95,17,2041,22203,10.8784909358158,113,0.0553650171484566,27,0.0132288094071534,SPA 3 - San Gabriel,District 5,7224037.26757813,14910.6321789113
176,San Pedro,5539374,24101,10338,5717320,37344,2396,78750,11256694,142.942146031746,61445,0.780253968253968,12734,0.161701587301587,SPA 8 - South Bay,District 4,336177694.071289,232237.596549193
177,Santa Clarita,820529,3570,1860,21453300,140529,8826,184649,22273829,120.627942745425,144099,0.780394153231266,10686,0.0578719624801651,SPA 2 - San Fernando,District 5,1598864326.49414,384844.434089353
178,Santa Fe Springs,48037,209,93,2334640,15460,892,15549,2382677,153.236671168564,15669,1.00771753810534,985,0.0633481252813686,SPA 7 - East,District 4,246875767.652344,160220.426811753
179,Santa Monica,842134,3664,1773,1066550,6859,491,89736,1908684,21.2699919764643,10523,0.117266203084604,2264,0.0252295622715521,SPA 5 - West,District 3,238780017.806641,69958.6187124341
180,Sawtelle,668834,2910,1445,434041,2786,202,35269,1102875,31.2703790864499,5696,0.161501601973404,1647,0.0466982335762284,SPA 5 - West,District 3,75025802.7509766,40276.5067841114
181,Sepulveda Basin,24823,108,54,7233,40,6,186,32056,172.344086021505,148,0.795698924731183,60,0.32258064516129,SPA 2 - San Fernando,District 3,87442217.3974609,47358.9920798385
182,Shadow Hills,449107,1954,891,312025,2057,123,13694,761132,55.581422520812,4011,0.292902000876296,1014,0.0740470278954286,SPA 2 - San Fernando,District 5,357035009.981445,109279.630529715
183,Sherman Oaks,1061171,4617,2658,370562,2326,194,63661,1431733,22.4899546032893,6943,0.109062063115565,2852,0.0447997989349837,SPA 2 - San Fernando,District 3,255001934.499023,83185.092263266
184,Sierra Madre,28500,124,55,92688,566,55,10917,121188,11.1008518823853,690,0.0632041769716955,110,0.010076028212879,SPA 3 - San Gabriel,District 5,82765201.7392578,40205.4753638411
185,Signal Hill,30339,132,67,271031,1801,101,11077,301370,27.2068249526045,1933,0.174505732599079,168,0.015166561343324,SPA 7 - East,District 4,61984695.4482422,57705.0252162445
186,Silver Lake,641943,2793,1313,331673,2142,149,29228,973616,33.3110715752019,4935,0.168844943205146,1462,0.0500205282605721,SPA 4 - Metro,District 1,76640658.6914063,41958.0254448856
187,South Diamond Bar,0,0,0,0,0,0,2823,0,0,0,0,0,0,SPA 3 - San Gabriel,District 1,149131150.486328,67504.3674537514
188,Southeast Antelope Valley,24823,108,43,2226400,15623,490,8149,2251223,276.257577616885,15731,1.93042091054117,533,0.0654067983801693,SPA 1 - Antelope Valley,District 5,5379427836.33008,520899.25976941
189,South El Monte,48266,210,104,6000320,40921,1806,16637,6048586,363.562300895594,41131,2.47226062391056,1910,0.114804351746108,SPA 3 - San Gabriel,District 1,81621796.1894531,62756.9942108042
190,South Gate,388430,1690,853,10237700,69249,3315,94396,10626130,112.569706343489,70939,0.751504301029705,4168,0.0441544133225984,SPA 7 - East,District 4,207648679.898438,103308.657561577
191,South Pasadena,22294,97,57,103695,615,69,25616,125989,4.91837133041849,712,0.0277951280449719,126,0.00491880074953154,SPA 3 - San Gabriel,District 5,95244271.9384766,44082.5236729974
192,South San Gabriel,17008,74,45,1617490,11294,379,11163,1634498,146.421033772283,11368,1.01836423900385,424,0.0379826211591866,SPA 3 - San Gabriel,District 1,39559510.2480469,69796.1168449763
193,South San Jose Hills,25512,111,55,5007710,32835,2047,19703,5033222,255.45460082221,32946,1.67213114754098,2102,0.106684261280008,SPA 3 - San Gabriel,District 1,41384088.7080078,44262.0553365012
194,South Whittier,115380,502,236,11288400,73147,4971,57102,11403780,199.708941893454,73649,1.28977969248012,5207,0.0911876992049315,SPA 7 - East,District 4,149771598.982422,77459.446813088
195,Stevenson Ranch,20915,91,55,501642,3082,290,9279,522557,56.3160900959155,3173,0.341954952042246,345,0.0371807306821856,SPA 2 - San Fernando,District 5,86804697.8808594,76995.4817880604
196,Studio City,543801,2366,1374,233485,1432,136,34695,777286,22.4034010664361,3798,0.1094682230869,1510,0.043522121343133,SPA 2 - San Fernando,District 5,175854826.15332,73567.551704293
197,Sunland,489559,2130,961,514636,3468,172,17032,1004195,58.9593118835134,5598,0.32867543447628,1133,0.0665218412400188,SPA 2 - San Fernando,District 5,111628361.772461,61084.2678895315
198,Sun Valley,3857635,16784,7864,1399860,9389,486,78863,5257495,66.666180591659,26173,0.331879335049389,8350,0.105879816897658,SPA 2 - San Fernando,District 3,262723871.869141,71589.3557639339
199,Sun Village,27581,120,56,4650590,32279,1169,8052,4678171,580.994908097367,32399,4.02372081470442,1225,0.152136115250869,SPA 1 - Antelope Valley,District 5,285170221.625,91954.4834817846
200,Sylmar,3183054,13849,6391,2087420,13934,752,78893,5270474,66.8053439468647,27783,0.352160521212275,7143,0.090540352122495,SPA 2 - San Fernando,District 3,347264078.137695,112352.160007645
201,Tarzana,941654,4097,2083,492751,3310,169,35593,1434405,40.3001994774253,7407,0.208102716826342,2252,0.0632708678672773,SPA 2 - San Fernando,District 3,245076216.295898,78774.8037514756
202,Temple City,39303,171,92,2202580,14560,852,35048,2241883,63.9660750970098,14731,0.420309290116412,944,0.0269344898425017,SPA 3 - San Gabriel,District 5,110955792.735352,60818.3663470035
203,Toluca Lake,126412,550,300,34336,174,35,9724,160748,16.531057178116,724,0.074454956807898,335,0.0344508432743727,SPA 2 - San Fernando,District 5,33934355.3359375,27253.9982501701
204,Topanga,42980,187,113,344686,2172,177,6151,387666,63.024874004227,2359,0.383514875629979,290,0.0471468053974963,SPA 2 - San Fernando,District 3,536323658.112305,137438.760949789
205,Torrance,335566,1460,768,2766540,17881,1237,144402,3102106,21.4824309912605,19341,0.133938588108198,2005,0.0138848492403152,SPA 8 - South Bay,District 4,573827672.792969,135145.382316898
206,Tujunga,803750,3497,1612,924095,6322,270,26812,1727845,64.4429732955393,9819,0.366216619424138,1882,0.07019245114128,SPA 2 - San Fernando,District 5,279224911.71582,96897.5490457543
207,Tujunga Canyons,13561,59,25,486289,3349,133,2857,499850,174.956247812391,3408,1.19285964298215,158,0.0553027651382569,SPA 3 - San Gabriel,District 5,6409058032.31152,570915.194406543
208,Unincorporated Catalina Island,690,3,1,4966,18,8,521,5656,10.8560460652591,21,0.0403071017274472,9,0.017274472168906,SPA 8 - South Bay,District 4,2021239394.11328,348621.335879681
209,Unincorporated Santa Monica Mountains,28500,124,69,247178,1372,203,17285,275678,15.9489730980619,1496,0.0865490309516922,272,0.0157361874457622,SPA 5 - West,District 3,2488316242.83984,306921.851876585
210,Unincorporated Santa Susana Mountains,28500,124,72,328803,2113,152,15215,357303,23.48360170884,2237,0.147025961222478,224,0.0147223135064082,SPA 2 - San Fernando,District 5,2177521946.58008,407268.665801432
211,Universal City,0,0,0,0,0,0,0,0,,0,,0,,SPA 2 - San Fernando,District 5,13391979.3642578,17328.3252509026
212,Valinda,26202,114,66,5647740,37277,2208,23506,5673942,241.382710797243,37391,1.59070024674551,2274,0.0967412575512635,SPA 3 - San Gabriel,District 1,55943011.8222656,53035.5570614321
213,Valley Glen,2495603,10858,5399,727308,4794,287,57959,3222911,55.6067392467089,15652,0.270052968477717,5686,0.098103832019186,SPA 2 - San Fernando,District 3,133970862.693359,52128.3992482629
214,Valley Village,512084,2228,1197,81576,404,87,24039,593660,24.6957028162569,2632,0.109488747452057,1284,0.0534132035442406,SPA 2 - San Fernando,District 5,58137594.6601563,31439.3159376171
215,Val Verde,27351,119,54,901636,6106,289,0,928987,,6225,,343,,SPA 2 - San Fernando,District 5,20339395.8378906,35279.9765005755
216,Van Nuys,6626057,28829,13511,1802050,11993,664,106451,8428107,79.1735822115339,40822,0.383481601863768,14175,0.133159857587059,SPA 2 - San Fernando,District 3,250652102.527344,78295.6822531328
217,Venice,1797119,7819,3366,1874320,12856,534,36962,3671439,99.3300957740382,20675,0.559358259834425,3900,0.105513770899843,SPA 5 - West,District 3,88395858.7050781,56612.6465472575
218,Vernon,58609,255,115,78736,485,45,112,137345,1226.29464285714,740,6.60714285714286,160,1.42857142857143,SPA 7 - East,District 4,145631232.30957,80350.616287982
219,Veterans Administration,127561,555,212,120377,802,44,746,247938,332.356568364611,1357,1.81903485254692,256,0.343163538873995,SPA 5 - West,District 3,25405080.9082031,29700.2655837831
220,Vincent,34476,150,68,2745500,18349,980,9965,2779976,278.974009031611,18499,1.85639739086804,1048,0.105168088309082,SPA 3 - San Gabriel,District 1,41232937.3046875,62982.4012287811
221,Walnut,17468,76,37,1313460,8490,587,29156,1330928,45.6485114556181,8566,0.293798875017149,624,0.0214021127726711,SPA 3 - San Gabriel,District 1,251268816.408203,92150.7234374492
222,Walnut Park,91706,399,187,2844670,18842,1085,15966,2936376,183.914317925592,19241,1.2051233871978,1272,0.0796692972566704,SPA 7 - East,District 4,20477122.7275391,23568.4180686918
223,West Adams,1374443,5980,2625,932007,6272,315,23349,2306450,98.7815323996745,12252,0.524733393293075,2940,0.125915456764744,SPA 6 - South,District 2,41316007.4697266,32348.7786752501
224,West Carson,124573,542,266,2466900,15981,1088,21699,2591473,119.428222498733,16523,0.761463661919904,1354,0.0623991889027144,SPA 8 - South Bay,District 2,63536571.5517578,44238.8303238444
225,Westchester,645161,2807,1408,626954,4053,280,39168,1272115,32.4784262663399,6860,0.175142973856209,1688,0.0430964052287582,SPA 5 - West,District 2,301343461.691406,98779.3738285317
226,West Compton,86880,378,175,2193410,15103,601,5150,2280290,442.774757281553,15481,3.00601941747573,776,0.150679611650485,SPA 8 - South Bay,District 2,46121012.9658203,30914.98498157
227,West Covina,180195,784,386,6021400,39302,2535,103188,6201595,60.0999631740125,40086,0.388475404116758,2921,0.0283075551420708,SPA 3 - San Gabriel,District 1,449248023.282227,201169.338868846
228,West Hills,756174,3290,1700,362473,2160,237,35997,1118647,31.0761174542323,5450,0.151401505681029,1937,0.0538100397255327,SPA 2 - San Fernando,District 3,237749128.910156,85400.6670610381
229,West Hollywood,335337,1459,784,1742510,10848,949,34407,2077847,60.3902403580667,12307,0.357688842386724,1733,0.0503676577440637,SPA 4 - Metro,District 3,52614888.625,57480.2967627599
230,Westlake,6308878,27449,12017,3251760,22083,1017,100789,9560638,94.857950768437,49532,0.491442518528808,13034,0.129319667820893,SPA 4 - Metro,District 1,75754113.7460938,35871.2614042454
231,Westlake Village,21605,94,54,154296,846,131,6022,175901,29.2097309863833,940,0.156094320823647,185,0.0307206908003985,SPA 2 - San Fernando,District 3,157413175.511719,64535.5887510362
232,West Los Angeles,95843,417,237,39182,235,25,14247,135025,9.47743384572191,652,0.0457640204955429,262,0.0183898364567979,SPA 5 - West,District 3,29260412.5986328,23188.4596975669
233,West Puente Valley,51484,224,106,7389060,50048,2365,22390,7440544,332.315497990174,50272,2.2452880750335,2471,0.110361768646717,SPA 3 - San Gabriel,District 1,51759707.0947266,58954.9558839856
234,West San Dimas,460,2,2,1440,6,2,0,1900,,8,,4,,SPA 3 - San Gabriel,District 5,9193886.60546875,23345.6044448003
235,West Whittier-Los Nietos,55162,240,124,7013990,46822,2526,25904,7069152,272.898085237801,47062,1.81678505250154,2650,0.102300802964793,SPA 7 - East,District 4,72881027.015625,75199.1927610358
236,Westwood,238114,1036,598,107725,643,70,51485,345839,6.71727687676022,1679,0.0326114402253083,668,0.0129746528114985,SPA 5 - West,District 3,102474768.521484,49822.2060833548
237,Whittier,169392,737,358,8485320,55902,3360,84878,8654712,101.966493084191,56639,0.667298946723533,3718,0.0438040481632461,SPA 7 - East,District 4,410945405.039063,160215.619655451
238,Whittier Narrows,1609,7,3,18776,115,11,2511,20385,8.11827956989247,122,0.0485862206292314,14,0.00557546794105934,SPA 3 - San Gabriel,District 1,80834517.0703125,74969.7603635867
239,Wilmington,2844500,12376,5307,6164570,41469,2090,54907,9009070,164.078714917952,53845,0.980658203872002,7397,0.134718706175897,SPA 8 - South Bay,District 4,254844558.759766,149138.196195605
240,Windsor Square,62516,272,135,151926,1033,47,4652,214442,46.0967325881341,1305,0.280524505588994,182,0.0391229578675838,SPA 4 - Metro,District 2,19053871.5029297,17867.4656853273
241,Winnetka,1760574,7660,3652,629519,4148,249,48788,2390093,48.9893621382307,11808,0.242026727883906,3901,0.0799581864392884,SPA 2 - San Fernando,District 3,133181800.388672,53223.29569049
242,Woodland Hills,1190801,5181,2841,676836,4181,382,62339,1867637,29.9593673302427,9362,0.15017886074528,3223,0.0517011822454643,SPA 2 - San Fernando,District 3,411716753.936523,105665.758108011
243,Westside South Central,38104024,165785,71461,55878600,373501,19926,498465,93982624,188.544078320444,539286,1.08189341277723,91387,0.183336844111422,SPA 6 - South,District 2,955180009.961914,224317.667941981
244,Eastside South Central,21803772,94865,40250,64233300,434327,20863,349795,86037072,245.964270501294,529192,1.51286324847411,61113,0.174710902099801,SPA 6 - South,District 2,575168651.486328,145996.786741128
